spelling	phoneme_list
aa	ɑː
ah	ɑː
ou	aʊ, ɔː, ə
ow	aʊ, oʊ
o	ɒ, oʊ, ɔː, ɜː, ə
eau	oʊ
ao	aʊ
i	aɪ, ɪ, aɪə, ɜː, ə
au	ɔː
aw	ɔː
oa	oʊ, ɔː
y	ɪ, aɪ, ɜː, aɪə, ɪ, iː
oi	ɔɪ, wɑː
ie	aɪ, iː, ɪə
a	æ, eɪ, ɑː, ɛə, ɒ, ɔː, ə, ɪ, ɛ
ei/ey	eɪ, iː, ɛə, ɪ, ə
ae	iː, ɛə
ai	eɪ, ɛə, ɪ, ə
uy	aɪ
e	iː, ɛ, ɜː, ɪə, ə, Ø
ea	iː, ɛ, ɜː, ɪə
ee	iː, ɪə
oe	iː, oʊ, ɪ
oo	uː, ʊ, ɔː
(i)eu/w	juː, uː, jʊə
u	ʌ, juː, uː, ɜː, Ø, w, ə
ay	eɪ
ui	wɪ, uː, ɪ
oeu	uː
oy	ɔɪ
uu	juə
ue	Ø, uː, juː