spelling	phoneme_list
a	æ, eɪ, ɑː, ɛə, ɒ, ɔː, ɪ, ɛ
aa	ɑː
ah	ɑː
ae	iː, ɛə
ai	eɪ, ɛə, ɪ
ao	aʊ
au	ɔː
aw	ɔː
ay	eɪ
e	iː, ɛ, ɜː, ɪə, Ø
ea	iː, ɛ, ɜː, ɪə
eau	oʊ
ee	iː, ɪə
ei	eɪ, iː, ɛə, ɪ
ey	eɪ, iː, ɛə, ɪ
eu	juː, uː, jʊə
ew	juː, uː, jʊə
ieu	juː, uː, jʊə
iew	juː, uː, jʊə
i	aɪ, ɪ, aɪə, ɜː
ie	aɪ, iː, ɪə
o	ɒ, oʊ, ɔː, ɜː
oa	oʊ, ɔː
oe	iː, oʊ, ɪ
oeu	uː
oi	ɔɪ, wɑː
oo	uː, ʊ, ɔː
ou	aʊ, ɔː
ow	aʊ, oʊ
oy	ɔɪ
u	ʌ, juː, uː, ɜː, Ø, w
ue	Ø, uː, juː
ui	wɪ, uː, ɪ
uu	juə
uy	aɪ
y	ɪ, aɪ, ɜː, aɪə, ɪ, iː